#########
##    # #
#   #   #
# #  #B #
# ## ## #
     ## #
 ### ## #
A ##    #
     ####
#########